in-pcs-bip-errors	/terminal-device/logical-channels/channel/ethernet/state/in-pcs-bip-errors
in-pcs-errored-seconds	/terminal-device/logical-channels/channel/ethernet/state/in-pcs-errored-seconds
in-pcs-severely-errored-seconds	/terminal-device/logical-channels/channel/ethernet/state/in-pcs-severely-errored-seconds
in-pcs-unavailable-seconds	/terminal-device/logical-channels/channel/ethernet/state/in-pcs-unavailable-seconds
out-pcs-bip-errors	/terminal-device/logical-channels/channel/ethernet/state/out-pcs-bip-errors
out-crc-errors	/terminal-device/logical-channels/channel/ethernet/state/out-crc-errors
out-block-errors	/terminal-device/logical-channels/channel/ethernet/state/out-block-errors
errored-seconds	/terminal-device/logical-channels/channel/otn/state/errored-seconds
severely-errored-seconds	/terminal-device/logical-channels/channel/otn/state/severely-errored-seconds
errored-blocks	/terminal-device/logical-channels/channel/otn/state/errored-blocks
background-block-errors	/terminal-device/logical-channels/channel/otn/state/background-block-errors
input-power	/components/component/port/oc-line-com:optical-port/oc-line-com:state/oc-line-com:input-power
output-power	/components/component/port/oc-line-com:optical-port/oc-line-com:state/oc-line-com:output-power
fec-corrected-bytes	/terminal-device/logical-channels/channel/otn/state/fec-corrected-bytes
fec-corrected-bits	/terminal-device/logical-channels/channel/otn/state/fec-corrected-bits
q-value instant	/terminal-device/logical-channels/channel/otn/state/q-value/instant
q-value average	/terminal-device/logical-channels/channel/otn/state/q-value/avg
q-value min	/terminal-device/logical-channels/channel/otn/state/q-value/min
q-value max	/terminal-device/logical-channels/channel/otn/state/q-value/max
esnr instant	/terminal-device/logical-channels/channel/otn/state/esnr/instant
esnr average	/terminal-device/logical-channels/channel/otn/state/esnr/avg
esnr min	/terminal-device/logical-channels/channel/otn/state/esnr/min
esnr max	/terminal-device/logical-channels/channel/otn/state/esnr/max
pre-fec-ber instant	/terminal-device/logical-channels/channel/otn/state/pre-fec-ber/instant
pre-fec-ber average	/terminal-device/logical-channels/channel/otn/state/pre-fec-ber/avg
pre-fec-ber min	/terminal-device/logical-channels/channel/otn/state/pre-fec-ber/min
pre-fec-ber max	/terminal-device/logical-channels/channel/otn/state/pre-fec-ber/max
post-fec-ber-fec-ber instant	/terminal-device/logical-channels/channel/otn/state/post-fec-ber/instant
post-fec-ber-fec-ber average	/terminal-device/logical-channels/channel/otn/state/post-fec-ber/avg
post-fec-ber-fec-ber min	/terminal-device/logical-channels/channel/otn/state/post-fec-ber/min
post-fec-ber-fec-ber max	/terminal-device/logical-channels/channel/otn/state/post-fec-ber/max
errored-seconds	/terminal-device/logical-channels/channel/otn/state/errored-seconds
severely-errored-seconds	/terminal-device/logical-channels/channel/otn/state/severely-errored-seconds
errored-blocks	/terminal-device/logical-channels/channel/otn/state/errored-blocks
background-block-errors	/terminal-device/logical-channels/channel/otn/state/background-block-errors
Rx Optical Power Avg	/components/component[name=n]/transceiver/physical-channels/channel[index=y]/state/input-power/avg
Rx Optical Power instant	/components/component[name=n]/transceiver/physical-channels/channel[index=y]/state/input-power/instant
Tx Optical Power Avg	/components/component[name=n]/transceiver/physical-channels/channel[index=y]/state/output-power/avg
Tx Optical Power instant	/components/component[name=n]/transceiver/physical-channels/channel[index=y]/state/output-power/instant
Rx Channel Power Avg	/components/component[name=n]/optical-channel/state/input-power/avg
Rx Channel Power instant	/components/component[name=n]/optical-channel/state/input-power/instant
Tx Channel Power Avg	/components/component[name=n]/optical-channel/state/output-power/avg
